###############
#             #
#     B       #
#        #   *#
# P      #    #
#  B    *#    #
#       #     #
#      #      #
#  B  #       #
#    #     *  #
#   #         #
#  #   B      #
#             #
#         *   #
###############