 ##########
##         ###  
#   #####    ##
#   # P #     #
#   BBBBB     #
#             #
#             #
#             #
#             #
#    ####     #
#   #   #     #
#   #   #     #
#   #   #     #
#   #   #*****#
#####   #######
