##########
# *      #
#    B   #
#        #
# P B    #
#    B   #
# *      #
#        #
#     *  #
##########