  ########
 #      ##
#  BPBB  ###
#        # #
#        # #
#        ###
#   ###  #
#  #  #  #
#**#  #* #
####  ####
