  ########
 #      ##
#  BPBBB #
#        #
#        #
#        #
#   ###  #
#  #  #  #
#**#  #* #
####  ####
