##########
#        #
#  # B*B*#
#  #######
# P      #
#  B   * #
#        #
#        #
#        #
##########