##########
# *      #
#    B   #
#     B *#
# P B    #
#    B   #
# *      #
#    B   #
#     *  #
##########